Level: 1
Zoo Size: 50x50
Resources: 1, 3, 4, 6, 9, 10, 11, 14, 15, 20, 21
Zoo Layout:
1 1 1 1 1 1 1 1 1 1 1 1 1 1 1 1 1 1 4 4 4 1 1 4 4 4 1 1 1 1 1 1 1 1 1 1 1 1 1 1 1 1 1 1 1 1 1 1 1 1
1 1 1 1 1 1 1 1 1 1 4 4 4 1 1 4 4 4 4 4 4 4 4 4 4 4 1 1 1 1 1 1 1 1 1 1 1 1 1 1 1 1 1 1 1 1 1 1 1 1
1 1 4 4 4 1 1 4 4 4 4 4 4 4 4 4 4 4 4 4 4 1 1 4 4 4 1 1 1 1 1 1 4 4 4 1 1 4 4 4 4 4 4 1 1 4 4 4 1 1
1 1 4 4 4 4 4 4 4 4 4 4 4 1 1 4 4 4 1 1 1 1 1 6 6 6 6 6 6 6 6 6 4 4 4 4 4 4 4 4 4 4 4 4 4 4 4 4 1 1
1 1 4 4 4 1 1 4 4 4 1 1 1 1 6 6 6 6 6 6 6 6 6 6 6 6 6 6 6 6 6 6 4 4 4 1 1 4 4 4 4 4 4 1 1 4 4 4 1 1
1 1 4 4 4 6 6 6 6 6 6 6 6 6 6 6 6 6 6 6 6 6 6 6 6 6 6 6 1 1 1 1 1 1 6 6 6 6 6 6 6 6 6 3 3 3 3 3 1 1
1 1 4 4 4 6 6 6 6 6 6 6 6 6 6 6 6 6 6 1 1 1 1 6 6 6 6 6 3 3 3 3 3 1 6 6 6 6 6 6 6 6 6 3 3 3 3 3 1 1
1 1 4 4 4 6 6 6 6 6 1 1 1 1 6 6 6 6 6 1 1 1 1 6 6 6 6 6 3 3 3 3 3 1 6 6 6 6 6 1 1 1 1 3 3 1 3 3 1 1
1 1 1 4 1 6 6 6 6 6 1 1 1 1 6 6 6 6 6 1 1 1 1 6 6 6 6 6 3 3 1 3 3 1 6 6 6 6 6 1 1 1 15 15 15 15 15 15 15 15
1 1 1 4 1 6 6 6 6 6 1 1 1 1 6 6 6 6 6 1 1 1 1 1 1 1 15 15 15 15 15 15 15 15 6 6 6 6 6 1 1 1 15 15 15 15 15 15 15 15
1 1 4 4 4 6 6 6 6 6 15 15 15 15 15 15 15 15 15 15 15 15 15 15 15 15 15 15 15 15 15 15 15 15 6 6 6 6 6 1 1 1 15 15 1 1 1 1 15 15
1 1 4 4 4 3 3 3 3 3 15 15 15 15 15 15 15 15 15 15 15 15 15 15 15 15 15 15 1 21 21 1 15 15 15 15 15 15 15 15 15 15 15 15 1 1 1 1 15 15
1 1 4 4 4 3 3 3 3 3 15 15 1 1 1 1 15 15 15 15 1 1 1 1 15 15 15 15 1 21 21 1 15 15 15 15 15 15 15 15 15 15 15 15 15 15 15 15 15 15
1 1 1 1 1 3 3 1 3 3 15 15 1 1 1 1 15 15 15 15 1 1 1 1 15 15 1 1 1 21 21 1 1 1 15 15 1 1 1 1 15 15 15 15 15 15 15 15 15 15
1 1 1 6 6 6 6 6 6 6 6 6 21 21 20 20 20 1 20 20 20 20 20 20 1 20 20 20 1 21 21 21 21 21 15 15 1 1 1 1 15 15 15 15 1 1 1 1 15 15
1 1 1 6 6 6 6 6 6 6 6 6 21 21 1 20 20 20 20 20 20 20 20 20 20 20 20 20 20 21 21 21 21 21 1 20 20 20 1 20 20 20 15 15 1 1 1 1 15 15
1 1 1 6 6 6 6 6 1 1 1 1 21 21 1 1 20 1 1 20 20 20 1 20 1 1 20 20 20 21 21 1 1 1 1 1 20 20 20 20 20 20 20 3 3 3 3 3 1 1
1 1 1 6 6 6 6 6 1 1 1 1 21 21 21 21 21 14 14 14 14 14 14 14 14 14 14 14 14 14 14 14 14 14 14 14 14 20 1 1 20 20 20 3 3 3 3 3 1 1
1 1 1 6 6 6 6 6 1 1 1 1 21 21 21 21 21 14 14 14 14 14 14 14 14 14 14 14 14 14 14 14 14 14 14 14 14 1 1 1 1 1 1 3 3 1 3 3 1 1
1 1 1 6 6 6 6 6 1 1 1 1 21 21 1 21 21 1 1 9 9 1 1 10 10 10 10 9 9 1 1 10 10 10 10 20 20 20 1 20 20 20 1 3 3 3 3 3 1 1
1 1 1 1 1 1 3 3 3 3 3 1 11 1 1 21 21 1 1 9 9 9 1 1 10 10 10 9 9 9 1 1 10 10 10 1 20 20 20 20 20 20 20 3 3 3 3 3 1 1
1 1 1 1 1 1 3 3 3 3 3 11 11 11 1 21 21 1 1 9 9 10 10 10 10 10 10 9 9 10 10 10 10 10 10 1 1 20 11 1 20 20 20 3 3 1 3 3 1 1
1 1 1 1 1 1 3 3 1 3 3 11 11 21 21 21 21 21 21 21 9 9 10 10 10 1 10 1 1 1 10 10 10 1 10 1 1 11 11 11 1 1 15 15 15 15 15 15 15 15
1 1 1 1 1 3 3 3 3 3 1 11 11 21 21 21 21 21 21 21 9 9 9 10 10 1 1 10 10 10 10 10 10 14 14 14 14 11 11 1 1 1 15 15 15 15 15 15 15 15
1 1 1 1 1 3 3 3 3 3 1 11 1 21 21 21 21 1 9 9 9 9 9 9 10 1 1 1 10 10 10 1 10 14 14 14 14 11 11 1 1 1 15 15 1 1 1 1 15 15
1 1 1 1 1 3 3 1 3 3 11 11 11 21 21 21 21 21 9 9 9 1 9 9 9 10 10 10 10 10 10 14 14 14 14 20 20 20 1 20 20 20 15 15 1 1 1 1 15 15
1 1 1 1 1 1 1 1 1 1 11 11 1 21 21 21 21 21 9 9 9 9 9 9 1 1 10 10 10 1 10 14 14 14 14 1 20 20 20 20 20 20 20 1 1 1 1 1 1 1
1 1 1 1 1 1 1 1 1 1 11 11 1 21 21 1 1 1 1 1 9 9 9 10 10 10 10 10 10 10 10 10 10 14 14 14 14 20 11 1 20 20 20 1 1 1 1 1 1 1
1 1 1 6 6 6 6 6 6 6 6 6 1 11 1 21 21 1 9 9 9 9 1 1 10 10 10 1 10 1 10 10 10 14 14 14 14 11 11 11 15 15 15 15 15 15 15 15 1 1
1 1 1 6 6 6 6 6 6 6 6 6 11 11 11 21 21 1 9 9 9 10 10 10 10 10 10 10 10 10 10 10 10 14 14 14 14 11 11 1 15 15 15 15 15 15 15 15 1 1
1 1 1 6 6 6 6 6 1 1 1 1 11 11 1 21 21 1 9 9 9 9 10 10 10 1 10 1 10 10 10 1 10 14 14 14 14 11 11 1 15 15 1 1 1 1 15 15 1 1
1 1 1 6 6 6 6 6 1 1 1 11 11 11 1 21 21 21 21 21 9 9 9 10 10 9 9 1 1 10 10 9 9 20 20 20 1 20 20 20 15 15 1 1 1 1 15 15 1 1
1 1 1 6 6 6 6 6 1 1 11 11 11 11 1 21 21 21 21 21 9 9 1 1 10 9 9 9 1 1 10 9 9 9 20 20 20 20 20 20 20 1 3 3 3 3 3 1 1 1
1 1 1 6 6 6 6 6 1 1 11 11 11 11 11 21 21 14 14 14 14 1 1 1 1 9 9 1 1 1 1 9 9 1 1 20 1 1 20 20 20 1 3 3 3 3 3 1 1 1
1 1 1 1 1 1 1 1 1 1 11 11 11 11 1 1 1 14 14 14 14 20 20 20 1 20 20 20 20 20 20 1 20 20 20 20 20 20 1 20 20 20 3 3 1 3 3 1 1 1
1 1 1 1 1 1 3 3 3 3 3 1 11 11 1 20 20 20 1 20 20 20 20 20 20 20 20 20 20 20 20 20 20 20 20 20 20 20 20 20 20 20 20 1 1 1 1 1 1 1
1 1 1 1 1 1 3 3 3 3 3 1 11 1 21 21 20 20 20 20 20 20 20 20 21 21 20 20 20 1 20 21 21 20 20 20 1 20 1 11 20 20 20 1 1 1 1 1 1 1
1 1 1 1 1 1 3 3 1 3 3 11 11 11 21 21 1 20 1 1 20 20 20 1 21 21 1 1 1 1 1 21 21 1 1 1 21 21 11 11 11 15 15 15 15 15 15 15 15 1
1 1 1 1 1 1 3 3 3 3 3 11 11 1 21 21 1 1 1 21 21 1 1 1 21 21 1 1 1 1 1 21 21 1 1 1 21 21 11 11 1 15 15 15 15 15 15 15 15 1
1 1 1 1 1 1 3 3 3 3 3 11 11 1 21 21 21 21 21 21 21 1 1 1 21 21 21 21 21 1 1 21 21 21 21 21 21 21 11 11 1 15 15 1 1 1 1 15 15 1
1 1 1 1 1 1 3 3 1 3 3 11 1 1 21 21 21 21 21 21 21 1 1 1 21 21 21 21 21 1 1 21 21 21 21 21 21 21 21 21 21 15 15 1 1 1 1 15 15 1
1 1 4 4 4 1 1 4 4 4 11 11 11 1 21 21 1 1 1 21 21 21 21 21 21 21 1 1 1 1 1 21 21 1 1 1 21 21 21 21 21 15 15 15 15 15 15 15 15 1
1 1 4 4 4 4 4 4 4 4 11 11 1 1 1 1 1 1 1 21 21 21 21 21 6 6 6 6 6 6 6 6 6 1 1 1 21 21 1 1 1 15 15 15 15 15 15 15 15 1
1 1 4 4 4 1 1 4 4 4 11 11 1 1 1 1 1 1 1 21 21 1 1 1 6 6 6 6 6 6 6 6 6 1 1 1 1 1 1 1 1 15 15 1 1 1 1 15 15 1
1 1 1 1 1 1 6 6 6 6 6 6 6 6 6 6 6 6 6 6 6 6 6 6 6 6 6 6 6 6 6 6 6 6 6 6 6 6 4 4 4 15 15 4 4 4 1 15 15 1
1 1 1 1 1 1 6 6 6 6 6 6 6 6 6 6 6 6 6 6 6 6 6 6 6 6 6 6 6 6 6 6 6 6 6 6 6 6 4 4 4 4 4 4 4 4 1 1 1 1
1 1 1 1 1 1 6 6 6 6 6 1 1 1 1 6 6 6 6 6 1 1 1 1 6 6 6 6 6 6 6 6 6 6 1 1 1 1 4 4 4 1 1 4 4 4 1 1 1 1
1 1 1 1 1 1 6 6 6 6 6 1 1 1 1 6 6 6 6 6 1 1 1 1 6 6 6 6 6 6 6 6 6 6 4 4 4 1 1 4 4 4 4 4 4 1 1 4 4 4
1 1 1 1 1 1 6 6 6 6 6 1 1 1 1 6 6 6 6 6 1 1 1 1 1 1 1 1 1 6 6 6 6 6 4 4 4 4 4 4 4 4 4 4 4 4 4 4 4 4
1 1 1 1 1 1 6 6 6 6 6 1 1 1 1 6 6 6 6 6 1 1 1 1 1 1 1 1 1 6 6 6 6 6 4 4 4 1 1 4 4 4 4 4 4 1 1 4 4 4